2222222222222222222222222222222
2000000000000000222222222222222
2222222220000000000000002222222
2222222222222022222220222222222
2222222222022022222220222222222
2222222222000000000000222222222
2222222222222220222222222222222
2222222222222220222222222222222
2111111111111111111111111111112
2222222222222222222222222222222