0000000000000000000000000000000
0111111111111111000000000000000
0000000001111111111111110000000
0000000000000100000001000000000
0000000000100100000001000000000
0000000000111111111111000000000
0000000000000001000000000000000
0000000000000001000000000000000
0222222222222222222222222222220
0000000000000000000000000000000